# # # # # # # # # # # # # # # # #
# . . . . . . . . . . . . . . . #
# . . . . . . . . . . . . . # . #
# . . . . . . . . . . # . . . . #
# . . . . . . . . . . . . . . . #
# . . . . . . . . . . # . . . . #
# . . . . . . . . . . . . . . . #
# . . . . . . . . . . . . . . . #
# . . . . . . . . . . . . . . . #
# . . . # . . . . . . . . . . . #
# . . . . . . . . . . . . . . . #
# . . . . . . . . . . . . . . . #
# O . . . . . . . . . . . . . . #
# # # # # # # # # # # # # # # # #
