# # # # # # # # # 
# . . . . . . . #
# . . # . . . . # 
# . . # . . . . #
# . . # . . . O #
# . . # . . . . # 
# . . # . . . . # 
# . . . . . . . #
# # # # # # # # # 
