# # # # # # # # # # # # # # # # #
# . . . . . . . . . . . . . . . #
# . . . . . . . . . . . . . . . #
# . . . . . . . . . . . . . . . #
# . . . . . . . . . . . . . . . #
# . . . . . . . . . . . . . . . #
# . . . . . . . . . . . . . . . #
# . . . . . . . . . . . . . . . #
# . . . . . . . . . . . . . . . #
# . . . . . . . . . . . . . . . #
# . . . . . . . . . . . . . . . #
# . . . . . . . . . . . . . . . #
# O . . . . . . . . . . . . . . #
# # # # # # # # # # # # # # # # #
