# # # # # # # # # 
# . # . . . . . #
# . # . # # # . # 
# . # . . . . . #
# . . . . # . . # 
# . . . . # . # # 
# O # # . # . # #
# # # # # # # # # 
