h = 0
-1 -1 -1 -1 -1 -1 -1 -1 -1 

-1 21 -1 11 12 22 -1 23 -1 

-1 18 10  4 -1 -1 -1 16 -1 

-1 15  7  3  0  1  5 13 -1 

-1 -1 -1 -1  2 -1  8 17 -1 

-1 25 20  9  6 -1 19 -1 -1 

-1 26 -1 -1 14 -1 24 -1 -1 

-1 -1 -1 -1 -1 -1 -1 -1 -1 

coste = 5

manhattan
-1 -1 -1 -1 -1 -1 -1 -1 -1 

-1 -1 -1 -1 -1 -1 -1 -1 -1 

-1 -1 -1 -1 -1 -1 -1 -1 -1 

-1 -1 -1 -1  0 -1 -1 -1 -1 

-1 -1 -1 -1  1 -1 -1 -1 -1 

-1 -1  3  2 -1 -1 -1 -1 -1 

-1  4 -1 -1 -1 -1 -1 -1 -1 

-1 -1 -1 -1 -1 -1 -1 -1 -1 


euclidea
-1 -1 -1 -1 -1 -1 -1 -1 -1 

-1 -1 -1 -1 -1 -1 -1 -1 -1 

-1 -1 -1 -1 -1 -1 -1 -1 -1 

-1 -1 -1  2  0 -1 -1 -1 -1 

-1 -1 -1 -1  1 -1 -1 -1 -1 

-1 -1  4  3 -1 -1 -1 -1 -1 

-1  5 -1 -1 -1 -1 -1 -1 -1 

-1 -1 -1 -1 -1 -1 -1 -1 -1


cheby
-1 -1 -1 -1 -1 -1 -1 -1 -1 

-1 -1 -1 -1 -1 -1 -1 -1 -1 

-1 -1 -1 -1 -1 -1 -1 -1 -1 

-1 -1  7  2  0  5 -1 -1 -1 

-1 -1 -1 -1  1 -1 -1 -1 -1 

-1 -1  4  3  6 -1 -1 -1 -1 

-1  8 -1 -1 -1 -1 -1 -1 -1 

-1 -1 -1 -1 -1 -1 -1 -1 -1 


coseno
-1 -1 -1 -1 -1 -1 -1 -1 -1 

-1 23 -1  8 11 19 -1 22 -1 

-1 20 10  4 -1 -1 -1 15 -1 

-1 16  7  3  0  1  5 13 -1 

-1 -1 -1 -1  2 -1  9 17 -1 

-1 25 21 12  6 -1 18 -1 -1 

-1 26 -1 -1 14 -1 24 -1 -1 

-1 -1 -1 -1 -1 -1 -1 -1 -1 
