h = 0
-1 -1 -1 -1 -1 -1 -1 -1 -1 

-1 35 31 29 27 22 18 15 -1 

-1 37 33 -1 25 14  9  6 -1 

-1 41 39 -1 21 12  5  1 -1 

-1 43 42 -1 17  8  3  0 -1 

-1 40 38 -1 20 11  4  2 -1 

-1 36 32 -1 24 13 10  7 -1 

-1 34 30 28 26 23 19 16 -1 

-1 -1 -1 -1 -1 -1 -1 -1 -1 


coste 9,5

manhattan
-1 -1 -1 -1 -1 -1 -1 -1 -1 

-1 -1 -1 -1 21 -1 -1 -1 -1 

-1 -1 -1 -1 15 13 17 19 -1 

-1 -1 -1 -1  9  7  5 10 -1 

-1 25 -1 -1  3  2  1  0 -1 

-1 24 -1 -1  8  6  4 11 -1 

-1 -1 23 -1 14 12 16 18 -1 

-1 -1 -1 22 20 -1 -1 -1 -1 

-1 -1 -1 -1 -1 -1 -1 -1 -1 


coste 9,5

euclidea
-1 -1 -1 -1 -1 -1 -1 -1 -1 

-1 -1 -1 25 21 23 29 -1 -1 

-1 -1 27 -1 15 13 17 19 -1 

-1 33 31 -1  9  7  5 10 -1 

-1 34 -1 -1  3  2  1  0 -1 

-1 32 30 -1  8  6  4 11 -1 

-1 -1 26 -1 14 12 16 18 -1 

-1 -1 -1 24 20 22 28 -1 -1 

-1 -1 -1 -1 -1 -1 -1 -1 -1 


coste 9,5


cheby
-1 -1 -1 -1 -1 -1 -1 -1 -1 

-1 -1 35 27 19 23 25 29 -1 

-1 -1 31 -1 15 13 17 21 -1 

-1 37 33 -1  9  7  5 10 -1 

-1 38 -1 -1  3  2  1  0 -1 

-1 36 32 -1  8  6  4 11 -1 

-1 -1 30 -1 14 12 16 20 -1 

-1 -1 34 26 18 22 24 28 -1 

-1 -1 -1 -1 -1 -1 -1 -1 -1 


coste 9,5


coseno
-1 -1 -1 -1 -1 -1 -1 -1 -1 

-1 34 30 28 26 22 17 13 -1 

-1 37 32 -1 23 14  9  6 -1 

-1 40 36 -1 19 10  4  1 -1 

-1 43 42 -1 15  7  2  0 -1 

-1 41 38 -1 21 11  5  3 -1 

-1 39 33 -1 25 18 12  8 -1 

-1 35 31 29 27 24 20 16 -1 

-1 -1 -1 -1 -1 -1 -1 -1 -1 

coste 9,5







