h = 0
-1 -1 -1 -1 -1 -1 -1 -1 -1 -1 -1 -1 -1 -1 -1 -1 -1 

-1 -1 -1 -1 -1 95 -1 -1 -1 94 -1 -1 -1 -1 -1 -1 -1 

-1 -1 -1 -1 -1 84 -1 -1 -1 82 91 88 90 -1 -1 -1 -1 

-1 -1 -1 -1 93 81 69 64 68 77 -1 76 79 87 89 -1 -1 

-1 -1 -1 -1 -1 83 -1 52 -1 62 -1 61 -1 75 -1 -1 -1 

-1 92 -1 78 -1 85 -1 38 -1 48 -1 47 -1 59 -1 86 -1 

-1 80 -1 63 -1 72 -1 28 -1 34 32 -1 -1 44 -1 73 -1 

-1 65 -1 49 53 70 -1 21 -1 -1 24 -1 29 -1 55 66 -1 

-1 58 45 33 -1 -1 -1 14 15 -1 19 20 27 37 51 -1 -1 

-1 57 42 30 22 16 11  8 -1 -1 13 -1 -1 41 54 67 -1 

-1 -1 -1 -1 25 -1  9  4  3 -1  6 -1 40 36 -1 60 -1 

-1 71 56 39 35 -1 10 -1  1  2  5 -1 -1 26 -1 46 -1 

-1 74 -1 -1 50 -1 17 -1  0 -1  7 12 18 23 31 43 -1 

-1 -1 -1 -1 -1 -1 -1 -1 -1 -1 -1 -1 -1 -1 -1 -1 -1 
coste 12,5


manhattan
-1 -1 -1 -1 -1 -1 -1 -1 -1 -1 -1 -1 -1 -1 -1 -1 -1 

-1 -1 -1 -1 -1 14 -1 -1 -1 -1 -1 -1 -1 -1 -1 -1 -1 

-1 -1 -1 -1 -1 13 -1 -1 -1 -1 -1 -1 -1 -1 -1 -1 -1 

-1 -1 -1 -1 -1 -1 12 -1 -1 -1 -1 -1 -1 -1 -1 -1 -1 

-1 -1 -1 -1 -1 -1 -1 11 -1 -1 -1 -1 -1 -1 -1 -1 -1 

-1 -1 -1 -1 -1 -1 -1 10 -1 -1 -1 -1 -1 -1 -1 -1 -1 

-1 -1 -1 -1 -1 -1 -1  9 -1 -1 -1 -1 -1 -1 -1 -1 -1 

-1 -1 -1 -1 -1 -1 -1  8 -1 -1 -1 -1 -1 -1 -1 -1 -1 

-1 -1 -1 -1 -1 -1 -1  7 -1 -1 -1 -1 -1 -1 -1 -1 -1 

-1 -1 -1 -1 -1  4  3  5 -1 -1 -1 -1 -1 -1 -1 -1 -1 

-1 -1 -1 -1 -1 -1  6  2 -1 -1 -1 -1 -1 -1 -1 -1 -1 

-1 -1 -1 -1 -1 -1 -1 -1  1 -1 -1 -1 -1 -1 -1 -1 -1 

-1 -1 -1 -1 -1 -1 -1 -1  0 -1 -1 -1 -1 -1 -1 -1 -1 

-1 -1 -1 -1 -1 -1 -1 -1 -1 -1 -1 -1 -1 -1 -1 -1 -1 

coste 12,5

euclidea
-1 -1 -1 -1 -1 -1 -1 -1 -1 -1 -1 -1 -1 -1 -1 -1 -1 

-1 -1 -1 -1 -1 15 -1 -1 -1 -1 -1 -1 -1 -1 -1 -1 -1 

-1 -1 -1 -1 -1 14 -1 -1 -1 -1 -1 -1 -1 -1 -1 -1 -1 

-1 -1 -1 -1 -1 -1 11 13 -1 -1 -1 -1 -1 -1 -1 -1 -1 

-1 -1 -1 -1 -1 -1 -1 10 -1 -1 -1 -1 -1 -1 -1 -1 -1 

-1 -1 -1 -1 -1 -1 -1  8 -1 -1 -1 -1 -1 -1 -1 -1 -1 

-1 -1 -1 -1 -1 -1 -1  7 -1 -1 -1 -1 -1 -1 -1 -1 -1 

-1 -1 -1 -1 -1 -1 -1  6 -1 -1 -1 -1 -1 -1 -1 -1 -1 

-1 -1 -1 -1 -1 -1 -1  5 -1 -1 -1 -1 -1 -1 -1 -1 -1 

-1 -1 -1 -1 -1 -1  9  4 -1 -1 -1 -1 -1 -1 -1 -1 -1 

-1 -1 -1 -1 -1 -1 -1  3  2 -1 -1 -1 -1 -1 -1 -1 -1 

-1 -1 -1 -1 -1 -1 -1 -1  1 12 -1 -1 -1 -1 -1 -1 -1 

-1 -1 -1 -1 -1 -1 -1 -1  0 -1 -1 -1 -1 -1 -1 -1 -1 

-1 -1 -1 -1 -1 -1 -1 -1 -1 -1 -1 -1 -1 -1 -1 -1 -1 


cheby
-1 -1 -1 -1 -1 -1 -1 -1 -1 -1 -1 -1 -1 -1 -1 -1 -1 

-1 -1 -1 -1 -1 26 -1 -1 -1 -1 -1 -1 -1 -1 -1 -1 -1 

-1 -1 -1 -1 -1 22 -1 -1 -1 -1 -1 -1 -1 -1 -1 -1 -1 

-1 -1 -1 -1 -1 -1 15 11 -1 -1 -1 -1 -1 -1 -1 -1 -1 

-1 -1 -1 -1 -1 -1 -1 10 -1 -1 -1 -1 -1 -1 -1 -1 -1 

-1 -1 -1 -1 -1 -1 -1  9 -1 25 -1 -1 -1 -1 -1 -1 -1 

-1 -1 -1 -1 -1 -1 -1  8 -1 24 19 -1 -1 -1 -1 -1 -1 

-1 -1 -1 -1 -1 -1 -1  7 -1 -1 18 -1 -1 -1 -1 -1 -1 

-1 -1 -1 -1 -1 -1 -1  6 14 -1 17 23 -1 -1 -1 -1 -1 

-1 -1 -1 -1 -1 -1 13  5 -1 -1 16 -1 -1 -1 -1 -1 -1 

-1 -1 -1 -1 -1 -1 21  4  2 -1 12 -1 -1 -1 -1 -1 -1 

-1 -1 -1 -1 -1 -1 -1 -1  1  3 20 -1 -1 -1 -1 -1 -1 

-1 -1 -1 -1 -1 -1 -1 -1  0 -1 -1 -1 -1 -1 -1 -1 -1 

-1 -1 -1 -1 -1 -1 -1 -1 -1 -1 -1 -1 -1 -1 -1 -1 -1 


coseno
-1 -1 -1 -1 -1 -1 -1 -1 -1 -1 -1 -1 -1 -1 -1 -1 -1 

-1 -1 -1 -1 -1 97 -1 -1 -1 95 -1 -1 -1 -1 -1 -1 -1 

-1 -1 -1 -1 -1 85 -1 -1 -1 88 93 89 91 -1 -1 -1 -1 

-1 -1 -1 -1 90 80 70 64 72 77 -1 79 81 87 92 -1 -1 

-1 94 -1 -1 -1 84 -1 50 -1 63 -1 66 -1 78 -1 96 -1 

-1 83 -1 73 -1 82 -1 37 -1 52 -1 54 -1 65 -1 86 -1 

-1 75 -1 59 -1 74 -1 26 -1 38 31 -1 -1 53 -1 76 -1 

-1 61 -1 46 55 67 -1 20 -1 -1 24 -1 32 -1 58 71 -1 

-1 56 44 34 -1 -1 -1 14 17 -1 19 21 28 39 51 -1 -1 

-1 47 36 29 22 16 11  9 -1 -1 13 -1 -1 43 57 69 -1 

-1 -1 -1 -1 25 -1  8  4  3 -1  7 -1 41 35 -1 62 -1 

-1 60 48 40 33 -1 10 -1  1  2  5 -1 -1 27 -1 49 -1 

-1 68 -1 -1 45 -1 15 -1  0 -1  6 12 18 23 30 42 -1 

-1 -1 -1 -1 -1 -1 -1 -1 -1 -1 -1 -1 -1 -1 -1 -1 -1 
