coseno
-1 -1 -1 -1 -1 -1 -1 -1 -1 

-1 26 -1 14 18 22 -1 13 -1 

-1 25 -1  9 -1 -1 -1  7 -1 

-1 23 -1  6  2  0  1  5 -1 

-1 20 15 -1  4 -1  3  8 -1 

-1 21 19 12 10 -1 11 -1 -1 

-1 24 -1 -1 16 -1 17 -1 -1 

-1 -1 -1 -1 -1 -1 -1 -1 -1 

coste = 7

cheby
-1 -1 -1 -1 -1 -1 -1 -1 -1 

-1 14 -1  5 11 -1 -1 -1 -1 

-1 13 -1  4 -1 -1 -1 -1 -1 

-1 12 -1  2  1  0  6 -1 -1 

-1 -1  8 -1  3 -1  7 -1 -1 

-1 -1 -1 10  9 -1 -1 -1 -1 

-1 -1 -1 -1 -1 -1 -1 -1 -1 

-1 -1 -1 -1 -1 -1 -1 -1 -1 


euclidea
-1 -1 -1 -1 -1 -1 -1 -1 -1 

-1 11 -1  4  8 -1 -1 -1 -1 

-1 10 -1  2 -1 -1 -1 -1 -1 

-1  9 -1  3  1  0  6 -1 -1 

-1 -1  7 -1  5 -1 -1 -1 -1 

-1 -1 -1 -1 -1 -1 -1 -1 -1 

-1 -1 -1 -1 -1 -1 -1 -1 -1 

-1 -1 -1 -1 -1 -1 -1 -1 -1


manhattan
-1 -1 -1 -1 -1 -1 -1 -1 -1 

-1 10 -1  3  5 -1 -1 -1 -1 

-1  9 -1  2 -1 -1 -1 -1 -1 

-1  8 -1  4  1  0 -1 -1 -1 

-1 -1  7 -1  6 -1 -1 -1 -1 

-1 -1 -1 -1 -1 -1 -1 -1 -1 

-1 -1 -1 -1 -1 -1 -1 -1 -1 

-1 -1 -1 -1 -1 -1 -1 -1 -1 


h = 0
-1 -1 -1 -1 -1 -1 -1 -1 -1 

-1 26 -1 15 18 23 -1 14 -1 

-1 25 -1  9 -1 -1 -1  7 -1 

-1 22 -1  6  2  0  1  5 -1 

-1 20 13 -1  4 -1  3  8 -1 

-1 21 19 12 11 -1 10 -1 -1 

-1 24 -1 -1 17 -1 16 -1 -1 

-1 -1 -1 -1 -1 -1 -1 -1 -1 
