coseno
-1 -1 -1 -1 -1 -1 -1 -1 -1 

-1 14 -1 17 19 22 26 28 -1 

-1  9 -1 15 -1 -1 -1 25 -1 

-1  6 -1 11 13 16 18 21 -1 

-1  3  4  7 12 -1 20 24 -1 

-1  1  2  5  8 -1 23 -1 -1 

-1  0 -1 -1 10 -1 27 -1 -1 

-1 -1 -1 -1 -1 -1 -1 -1 -1 


coste = 9

cheby
-1 -1 -1 -1 -1 -1 -1 -1 -1 

-1 -1 -1 -1 -1 -1 -1 17 -1 

-1 -1 -1 15 -1 -1 -1 16 -1 

-1 14 -1 11  8  9 12 -1 -1 

-1 10  6  4  5 -1 -1 -1 -1 

-1  3  1  2  7 -1 -1 -1 -1 

-1  0 -1 -1 13 -1 -1 -1 -1 

-1 -1 -1 -1 -1 -1 -1 -1 -1 

coste = 9


euclidea
-1 -1 -1 -1 -1 -1 -1 -1 -1 

-1 -1 -1 -1 -1 -1 -1 14 -1 

-1 -1 -1 -1 -1 -1 -1 13 -1 

-1 -1 -1  9  3  7 12 -1 -1 

-1 11  8  2  6 -1 -1 -1 -1 

-1  5  1  4 10 -1 -1 -1 -1 

-1  0 -1 -1 -1 -1 -1 -1 -1 

-1 -1 -1 -1 -1 -1 -1 -1 -1 


coste = 9

manhattan
-1 -1 -1 -1 -1 -1 -1 -1 -1 

-1 -1 -1 -1 -1 -1 -1  7 -1 

-1 -1 -1 -1 -1 -1 -1  6 -1 

-1 -1 -1 -1  3  4  5 -1 -1 

-1 -1 -1  2 -1 -1 -1 -1 -1 

-1 -1  1 -1 -1 -1 -1 -1 -1 

-1  0 -1 -1 -1 -1 -1 -1 -1 

-1 -1 -1 -1 -1 -1 -1 -1 -1 

coste = 9


coseno
-1 -1 -1 -1 -1 -1 -1 -1 -1 

-1 15 -1 17 18 21 26 27 -1 

-1 12 -1 14 -1 -1 -1 23 -1 

-1  7 -1  9 13 16 19 22 -1 

-1  3  4  6 10 -1 20 24 -1 

-1  1  2  5  8 -1 25 -1 -1 

-1  0 -1 -1 11 -1 -1 -1 -1 

-1 -1 -1 -1 -1 -1 -1 -1 -1 

coste = 9
