Manhattan
-1 -1 -1 -1 -1 -1 -1 -1 -1 -1 -1 -1 -1 -1 -1 -1 -1 

-1 -1 -1 -1 -1 -1 -1 -1 -1 -1 -1 11 12 13 14 15 -1 

-1 -1 -1 -1 -1 -1 -1 -1 -1 -1 10 -1 -1 -1 -1 -1 -1 

-1 -1 -1 -1 -1 -1 -1 -1 -1  9 -1 -1 -1 -1 -1 -1 -1 

-1 -1 -1 -1 -1 -1 -1 -1  8 -1 -1 -1 -1 -1 -1 -1 -1 

-1 -1 -1 -1 -1 -1 -1  7 -1 -1 -1 -1 -1 -1 -1 -1 -1 

-1 -1 -1 -1 -1 -1  6 -1 -1 -1 -1 -1 -1 -1 -1 -1 -1 

-1 -1 -1 -1 -1  5 -1 -1 -1 -1 -1 -1 -1 -1 -1 -1 -1 

-1 -1 -1 -1  4 -1 -1 -1 -1 -1 -1 -1 -1 -1 -1 -1 -1 

-1 -1 -1  3 -1 -1 -1 -1 -1 -1 -1 -1 -1 -1 -1 -1 -1 

-1 -1 -1  2 -1 -1 -1 -1 -1 -1 -1 -1 -1 -1 -1 -1 -1 

-1 -1  1 -1 -1 -1 -1 -1 -1 -1 -1 -1 -1 -1 -1 -1 -1 

-1  0 -1 -1 -1 -1 -1 -1 -1 -1 -1 -1 -1 -1 -1 -1 -1 

-1 -1 -1 -1 -1 -1 -1 -1 -1 -1 -1 -1 -1 -1 -1 -1 -1 

Coste 20

h = 0
-1 -1 -1 -1 -1 -1 -1 -1 -1 -1 -1 -1 -1 -1 -1 -1 -1 

-1 93 101 107 115 122 127 133 140 145 150 156 166 171 172 175 -1 

-1 78 84 91 99 105 112 120 126 131 139 153 163 164 -1 174 -1 

-1 63 70 76 82 88 97 103 110 118 135 -1 151 162 168 173 -1 

-1 51 57 61 67 74 80 86 95 114 119 132 149 157 165 170 -1 

-1 40 44 48 55 59 65 72 90 96 111 -1 141 152 160 169 -1 

-1 29 33 38 42 46 53 69 73 87 104 121 134 146 158 167 -1 

-1 21 25 27 31 36 50 54 66 81 98 113 128 142 154 161 -1 

-1 15 17 19 23 35 37 47 60 75 89 106 123 136 147 159 -1 

-1  9 11 13 -1 24 32 43 56 68 83 100 116 129 143 155 -1 

-1  4  6  8 14 20 28 39 49 62 77 92 108 124 137 148 -1 

-1  1  3  7 12 18 26 34 45 58 71 85 102 117 130 144 -1 

-1  0  2  5 10 16 22 30 41 52 64 79 94 109 125 138 -1 

-1 -1 -1 -1 -1 -1 -1 -1 -1 -1 -1 -1 -1 -1 -1 -1 -1 

coste 19,5


euclidea
-1 -1 -1 -1 -1 -1 -1 -1 -1 -1 -1 -1 -1 -1 -1 -1 -1 

-1 -1 -1 -1 -1 -1 -1 -1 -1 -1 -1 -1 -1 -1 68 69 -1 

-1 -1 -1 -1 -1 -1 -1 -1 -1 -1 -1 -1 -1 54 -1 -1 -1 

-1 -1 -1 -1 -1 -1 -1 -1 -1 59 62 -1 46 60 -1 -1 -1 

-1 -1 -1 -1 -1 -1 -1 -1 47 51 32 41 55 -1 -1 -1 -1 

-1 -1 -1 -1 -1 -1 61 38 44 24 36 -1 67 -1 -1 -1 -1 

-1 -1 -1 -1 -1 50 28 37 18 29 45 64 -1 -1 -1 -1 -1 

-1 -1 -1 65 42 22 31 14 25 40 58 -1 -1 -1 -1 -1 -1 

-1 -1 56 34 15 23 11 19 35 53 -1 -1 -1 -1 -1 -1 -1 

-1 48 27 12 -1  8 16 30 49 66 -1 -1 -1 -1 -1 -1 -1 

-1 21  9  2  6 13 26 43 63 -1 -1 -1 -1 -1 -1 -1 -1 

-1  5  1  4 10 20 39 57 -1 -1 -1 -1 -1 -1 -1 -1 -1 

-1  0  3  7 17 33 52 -1 -1 -1 -1 -1 -1 -1 -1 -1 -1 

-1 -1 -1 -1 -1 -1 -1 -1 -1 -1 -1 -1 -1 -1 -1 -1 -1 

coste 19,5 

cheby
-1 -1 -1 -1 -1 -1 -1 -1 -1 -1 -1 -1 -1 -1 -1 -1 -1 

-1 -1 -1 -1 -1 -1 -1 -1 -1 -1 -1 -1 -1 -1 100 101 -1 

-1 -1 -1 -1 -1 -1 -1 -1 -1 -1 99 97 96 87 -1 -1 -1 

-1 -1 -1 -1 -1 -1 -1 -1 95 85 84 -1 74 75 98 -1 -1 

-1 -1 -1 -1 -1 -1 92 82 72 71 62 63 64 86 -1 -1 -1 

-1 -1 -1 -1 91 80 70 60 59 51 52 -1 73 94 -1 -1 -1 

-1 -1 88 79 67 58 49 48 41 42 43 61 83 -1 -1 -1 -1 

-1 76 66 55 47 39 38 31 32 33 50 69 93 -1 -1 -1 -1 

-1 53 44 37 29 28 23 24 25 40 57 81 -1 -1 -1 -1 -1 

-1 34 26 21 -1 16 17 18 30 46 68 90 -1 -1 -1 -1 -1 

-1 19 14 10 11 12 13 22 36 56 78 -1 -1 -1 -1 -1 -1 

-1  8  4  5  6  7 15 27 45 65 89 -1 -1 -1 -1 -1 -1 

-1  0  1  2  3  9 20 35 54 77 -1 -1 -1 -1 -1 -1 -1 

-1 -1 -1 -1 -1 -1 -1 -1 -1 -1 -1 -1 -1 -1 -1 -1 -1 
coste 19,5


coseno
-1 -1 -1 -1 -1 -1 -1 -1 -1 -1 -1 -1 -1 -1 -1 -1 -1 

-1 86 99 109 117 125 130 138 144 149 155 159 167 171 173 175 -1 

-1 72 80 90 100 108 116 124 129 137 143 154 163 166 -1 174 -1 

-1 59 65 74 84 93 101 107 115 123 136 -1 153 162 169 172 -1 

-1 46 53 60 67 77 85 94 102 114 122 135 148 158 165 170 -1 

-1 36 42 47 54 63 71 79 92 98 113 -1 142 152 161 168 -1 

-1 27 31 37 43 50 57 70 78 91 106 121 134 147 157 164 -1 

-1 19 23 28 32 40 51 58 69 83 97 112 128 141 151 160 -1 

-1 13 17 20 24 33 41 52 64 76 89 105 120 133 146 156 -1 

-1  8 11 14 -1 26 35 45 56 68 82 96 111 127 140 150 -1 

-1  4  6  9 15 21 30 39 49 62 75 88 104 119 132 145 -1 

-1  1  3  7 12 18 25 34 44 55 66 81 95 110 126 139 -1 

-1  0  2  5 10 16 22 29 38 48 61 73 87 103 118 131 -1 

-1 -1 -1 -1 -1 -1 -1 -1 -1 -1 -1 -1 -1 -1 -1 -1 -1 

coste 19,5
