COSENO
-1 -1 -1 -1 -1 -1 -1 -1 -1 -1 -1 -1 -1 -1 -1 -1 -1 

-1 -1 -1 -1 -1 61 66 74 79 75 80 -1 97 -1 108 109 -1 

-1 -1 -1 -1 -1 54 -1 -1 -1 65 73 84 92 -1 105 -1 -1 

-1 45 48 56 51 47 52 53 55 60 -1 89 96 102 104 107 -1 

-1 39 -1 -1 -1 42 -1 46 -1 64 -1 95 -1 101 -1 106 -1 

-1 34 -1 31 -1 38 -1 40 -1 72 -1 88 -1 94 -1 103 -1 

-1 28 -1 24 -1 33 -1 35 -1 77 70 -1 -1 87 -1 100 -1 

-1 22 -1 16 20 26 -1 30 -1 -1 63 -1 71 -1 91 99 -1 

-1 18 13 11 -1 -1 -1 23 29 -1 58 59 68 78 86 -1 -1 

-1 15 10  8  7  9 12 17 -1 -1 50 -1 -1 83 90 98 -1 

-1 -1 -1 -1  6 -1 14 21 27 -1 44 -1 81 76 -1 93 -1 

-1  1  2  3  4 -1 19 -1 32 37 41 -1 -1 67 -1 85 -1 

-1  0 -1 -1  5 -1 25 -1 36 -1 43 49 57 62 69 82 -1 

-1 -1 -1 -1 -1 -1 -1 -1 -1 -1 -1 -1 -1 -1 -1 -1 -1 




h = 0
-1 -1 -1 -1 -1 -1 -1 -1 -1 -1 -1 -1 -1 -1 -1 -1 -1 

-1 -1 -1 -1 -1 61 64 73 77 71 76 -1 93 -1 108 109 -1 

-1 -1 -1 -1 -1 55 -1 -1 -1 62 70 83 92 -1 105 -1 -1 

-1 47 51 57 50 46 49 53 54 60 -1 86 94 101 104 107 -1 

-1 42 -1 -1 -1 41 -1 45 -1 63 -1 96 -1 102 -1 106 -1 

-1 38 -1 33 -1 36 -1 39 -1 72 -1 88 -1 95 -1 103 -1 

-1 32 -1 24 -1 30 -1 34 -1 78 75 -1 -1 85 -1 100 -1 

-1 23 -1 15 18 27 -1 28 -1 -1 66 -1 69 -1 91 98 -1 

-1 21 14 10 -1 -1 -1 19 25 -1 58 59 68 80 89 -1 -1 

-1 17 12  9  7  8 11 16 -1 -1 52 -1 -1 82 90 99 -1 

-1 -1 -1 -1  5 -1 13 20 26 -1 43 -1 81 79 -1 97 -1 

-1  1  2  3  4 -1 22 -1 31 35 40 -1 -1 67 -1 87 -1 

-1  0 -1 -1  6 -1 29 -1 37 -1 44 48 56 65 74 84 -1 

-1 -1 -1 -1 -1 -1 -1 -1 -1 -1 -1 -1 -1 -1 -1 -1 -1 

coste = 22,5

chebyshev
-1 -1 -1 -1 -1 -1 -1 -1 -1 -1 -1 -1 -1 -1 -1 -1 -1 

-1 -1 -1 -1 -1 -1 -1 -1 -1 61 52 -1 55 -1 -1 72 -1 

-1 -1 -1 -1 -1 -1 -1 -1 -1 38 40 42 44 -1 64 -1 -1 

-1 -1 -1 -1 -1 67 60 36 34 35 -1 53 56 57 70 -1 -1 

-1 -1 -1 -1 -1 51 -1 30 -1 39 -1 68 -1 -1 -1 -1 -1 

-1 -1 -1 50 -1 33 -1 21 -1 62 -1 58 -1 -1 -1 -1 -1 

-1 -1 -1 32 -1 27 -1 19 -1 66 46 -1 -1 71 -1 -1 -1 

-1 65 -1 26 22 23 -1 15 -1 -1 45 -1 63 -1 -1 -1 -1 

-1 59 28 20 -1 -1 -1 12 13 -1 43 54 69 -1 -1 -1 -1 

-1 48 25 16 10  7  8  9 -1 -1 41 -1 -1 -1 -1 -1 -1 

-1 -1 -1 -1  5 -1 11 14 17 -1 37 -1 -1 -1 -1 -1 -1 

-1  4  1  2  3 -1 18 -1 24 31 49 -1 -1 -1 -1 -1 -1 

-1  0 -1 -1  6 -1 29 -1 47 -1 -1 -1 -1 -1 -1 -1 -1 

-1 -1 -1 -1 -1 -1 -1 -1 -1 -1 -1 -1 -1 -1 -1 -1 -1 

euclidea
-1 -1 -1 -1 -1 -1 -1 -1 -1 -1 -1 -1 -1 -1 -1 -1 -1 

-1 -1 -1 -1 -1 -1 -1 -1 -1 44 36 -1 37 -1 -1 53 -1 

-1 -1 -1 -1 -1 -1 -1 -1 -1 28 29 30 31 -1 51 -1 -1 

-1 -1 -1 -1 -1 -1 48 32 25 26 -1 43 45 50 -1 -1 -1 

-1 -1 -1 -1 -1 42 -1 22 -1 39 -1 -1 -1 -1 -1 -1 -1 

-1 -1 -1 46 -1 33 -1 17 -1 -1 -1 -1 -1 -1 -1 -1 -1 

-1 -1 -1 35 -1 24 -1 13 -1 -1 -1 -1 -1 -1 -1 -1 -1 

-1 -1 -1 27 21 23 -1 12 -1 -1 -1 -1 -1 -1 -1 -1 -1 

-1 -1 41 19 -1 -1 -1  9 11 -1 -1 -1 -1 -1 -1 -1 -1 

-1 -1 40 16  8  5  7 10 -1 -1 52 -1 -1 -1 -1 -1 -1 

-1 -1 -1 -1  4 -1 15 18 20 -1 49 -1 -1 -1 -1 -1 -1 

-1  3  1  2  6 -1 34 -1 38 47 -1 -1 -1 -1 -1 -1 -1 

-1  0 -1 -1 14 -1 -1 -1 -1 -1 -1 -1 -1 -1 -1 -1 -1 

-1 -1 -1 -1 -1 -1 -1 -1 -1 -1 -1 -1 -1 -1 -1 -1 -1 


manhattan
-1 -1 -1 -1 -1 -1 -1 -1 -1 -1 -1 -1 -1 -1 -1 -1 -1 

-1 -1 -1 -1 -1 -1 -1 -1 23 15 14 -1 18 -1 -1 28 -1 

-1 -1 -1 -1 -1 -1 -1 -1 -1 13 16 17 19 -1 27 -1 -1 

-1 -1 -1 -1 -1 -1 -1 21 12 20 -1 24 25 26 -1 -1 -1 

-1 -1 -1 -1 -1 -1 -1 11 -1 -1 -1 -1 -1 -1 -1 -1 -1 

-1 -1 -1 -1 -1 -1 -1 10 -1 -1 -1 -1 -1 -1 -1 -1 -1 

-1 -1 -1 -1 -1 -1 -1  9 -1 -1 -1 -1 -1 -1 -1 -1 -1 

-1 -1 -1 -1 -1 -1 -1  7 -1 -1 -1 -1 -1 -1 -1 -1 -1 

-1 -1 -1 -1 -1 -1 -1  6  8 -1 -1 -1 -1 -1 -1 -1 -1 

-1 -1 -1 -1 -1  4  5 22 -1 -1 -1 -1 -1 -1 -1 -1 -1 

-1 -1 -1 -1  3 -1 -1 -1 -1 -1 -1 -1 -1 -1 -1 -1 -1 

-1 -1  1  2 -1 -1 -1 -1 -1 -1 -1 -1 -1 -1 -1 -1 -1 

-1  0 -1 -1 -1 -1 -1 -1 -1 -1 -1 -1 -1 -1 -1 -1 -1 

-1 -1 -1 -1 -1 -1 -1 -1 -1 -1 -1 -1 -1 -1 -1 -1 -1 

coste = 0
