manhattan
-1 -1 -1 -1 -1 -1 -1 -1 -1 -1 -1 -1 -1 -1 -1 -1 -1 

-1 -1 -1 -1 -1 -1 -1 -1 -1 -1 -1 -1 11 12 13 14 -1 

-1 -1 -1 -1 -1 -1 -1 -1 -1 -1 -1 10 -1 -1 -1 -1 -1 

-1 -1 -1 -1 -1 -1 -1 -1 -1 -1  9 -1 -1 -1 -1 -1 -1 

-1 -1 -1 -1 -1 -1 -1 -1 -1  8 -1 -1 -1 -1 -1 -1 -1 

-1 -1 -1 -1 -1 -1 -1 -1  7 -1 -1 -1 -1 -1 -1 -1 -1 

-1 -1 -1 -1 -1 -1 -1  6 -1 -1 -1 -1 -1 -1 -1 -1 -1 

-1 -1 -1 -1 -1 -1  5 -1 -1 -1 -1 -1 -1 -1 -1 -1 -1 

-1 -1 -1 -1 -1  4 -1 -1 -1 -1 -1 -1 -1 -1 -1 -1 -1 

-1 -1 -1 -1  3 -1 -1 -1 -1 -1 -1 -1 -1 -1 -1 -1 -1 

-1 -1 -1  2 -1 -1 -1 -1 -1 -1 -1 -1 -1 -1 -1 -1 -1 

-1 -1  1 -1 -1 -1 -1 -1 -1 -1 -1 -1 -1 -1 -1 -1 -1 

-1  0 -1 -1 -1 -1 -1 -1 -1 -1 -1 -1 -1 -1 -1 -1 -1 

-1 -1 -1 -1 -1 -1 -1 -1 -1 -1 -1 -1 -1 -1 -1 -1 -1 

coste = 19,5

h = 0
-1 -1 -1 -1 -1 -1 -1 -1 -1 -1 -1 -1 -1 -1 -1 -1 -1 

-1 94 102 109 116 123 130 136 143 149 154 159 164 171 176 179 -1 

-1 79 86 92 100 107 114 121 128 134 141 148 160 168 174 178 -1 

-1 65 71 77 84 90 98 105 112 119 127 142 155 165 172 177 -1 

-1 52 58 63 69 75 82 88 96 104 120 135 150 161 169 175 -1 

-1 41 46 50 56 61 67 73 81 97 113 129 144 156 166 173 -1 

-1 31 35 39 44 48 54 60 74 89 106 122 137 151 162 170 -1 

-1 22 26 29 33 37 43 55 68 83 99 115 131 145 157 167 -1 

-1 15 18 20 24 28 38 49 62 76 91 108 124 138 152 163 -1 

-1  9 11 13 17 25 34 45 57 70 85 101 117 132 146 158 -1 

-1  4  6  8 14 21 30 40 51 64 78 93 110 125 139 153 -1 

-1  1  3  7 12 19 27 36 47 59 72 87 103 118 133 147 -1 

-1  0  2  5 10 16 23 32 42 53 66 80 95 111 126 140 -1 

-1 -1 -1 -1 -1 -1 -1 -1 -1 -1 -1 -1 -1 -1 -1 -1 -1 

coste 19,5


euclidea
-1 -1 -1 -1 -1 -1 -1 -1 -1 -1 -1 -1 -1 -1 -1 -1 -1 

-1 -1 -1 -1 -1 -1 -1 -1 -1 -1 -1 -1 74 75 76 77 -1 

-1 -1 -1 -1 -1 -1 -1 -1 -1 -1 -1 52 56 60 70 -1 -1 

-1 -1 -1 -1 -1 -1 -1 -1 -1 65 38 44 50 66 -1 -1 -1 

-1 -1 -1 -1 -1 -1 -1 -1 51 28 36 46 61 -1 -1 -1 -1 

-1 -1 -1 -1 -1 -1 67 42 22 29 41 55 73 -1 -1 -1 -1 

-1 -1 -1 -1 -1 57 33 16 23 34 49 69 -1 -1 -1 -1 -1 

-1 -1 -1 71 47 27 12 18 30 45 64 -1 -1 -1 -1 -1 -1 

-1 -1 62 39 19  7 14 24 40 59 -1 -1 -1 -1 -1 -1 -1 

-1 53 32 15  4 10 20 35 54 72 -1 -1 -1 -1 -1 -1 -1 

-1 26 11  2  8 17 31 48 68 -1 -1 -1 -1 -1 -1 -1 -1 

-1  6  1  5 13 25 43 63 -1 -1 -1 -1 -1 -1 -1 -1 -1 

-1  0  3  9 21 37 58 -1 -1 -1 -1 -1 -1 -1 -1 -1 -1 

-1 -1 -1 -1 -1 -1 -1 -1 -1 -1 -1 -1 -1 -1 -1 -1 -1 

coste 19,5

cheby
-1 -1 -1 -1 -1 -1 -1 -1 -1 -1 -1 -1 -1 -1 -1 -1 -1 

-1 -1 -1 -1 -1 -1 -1 -1 -1 -1 -1 -1 104 105 106 107 -1 

-1 -1 -1 -1 -1 -1 -1 -1 -1 -1 102 90 91 92 93 -1 -1 

-1 -1 -1 -1 -1 -1 -1 -1 100 88 76 77 78 79 103 -1 -1 

-1 -1 -1 -1 -1 -1 98 86 74 64 65 66 67 89 -1 -1 -1 

-1 -1 -1 -1 96 84 72 62 52 53 54 55 75 101 -1 -1 -1 

-1 -1 94 82 70 60 50 42 43 44 45 63 87 -1 -1 -1 -1 

-1 80 68 58 48 40 32 33 34 35 51 73 99 -1 -1 -1 -1 

-1 56 46 38 30 24 25 26 27 41 61 85 -1 -1 -1 -1 -1 

-1 36 28 22 16 17 18 19 31 49 71 97 -1 -1 -1 -1 -1 

-1 20 14 10 11 12 13 23 39 59 83 -1 -1 -1 -1 -1 -1 

-1  8  4  5  6  7 15 29 47 69 95 -1 -1 -1 -1 -1 -1 

-1  0  1  2  3  9 21 37 57 81 -1 -1 -1 -1 -1 -1 -1 

-1 -1 -1 -1 -1 -1 -1 -1 -1 -1 -1 -1 -1 -1 -1 -1 -1 


coste = 19,5

coseno

-1 -1 -1 -1 -1 -1 -1 -1 -1 -1 -1 -1 -1 -1 -1 -1 -1 

-1 88 100 111 118 126 133 140 147 153 158 163 167 173 177 179 -1 

-1 73 81 92 101 110 117 125 132 139 146 152 162 170 175 178 -1 

-1 60 67 75 85 94 102 109 116 124 131 145 157 166 172 176 -1 

-1 48 54 61 69 78 86 95 103 108 123 138 151 161 169 174 -1 

-1 37 43 49 55 64 72 80 87 99 115 130 144 156 165 171 -1 

-1 28 33 38 44 52 58 66 79 93 107 122 137 150 160 168 -1 

-1 20 24 29 34 41 47 59 71 84 98 114 129 143 155 164 -1 

-1 13 17 21 25 32 42 53 65 77 91 106 121 136 149 159 -1 

-1  8 11 14 18 27 36 46 57 70 83 97 113 128 142 154 -1 

-1  4  6  9 15 22 31 40 51 63 76 90 105 120 135 148 -1 

-1  1  3  7 12 19 26 35 45 56 68 82 96 112 127 141 -1 

-1  0  2  5 10 16 23 30 39 50 62 74 89 104 119 134 -1 

-1 -1 -1 -1 -1 -1 -1 -1 -1 -1 -1 -1 -1 -1 -1 -1 -1 

coste = 19,5

