# # # # # # # # # 
# . . . . . . . #
# . . # . . . . # 
# . . # . . . . #
# . . # O . . . #
# . . # . . . . # 
# . . # . . . . # 
# . . . . . . . #
# # # # # # # # # 
